School – โรงเรียน

What – อะไร

Do – ทำ

Have – มี

Can – สามารถ

Like – ชอบ

Read – อ่าน

With – กับ

At – ที่

Look – มอง

Out – ข้างนอก

Up – ขึ้น

Very – มาก

Down – ลง

Sit – นั่ง

Jump – กระโดด

Hat – หมวก

Here – ที่นี่

Where – ที่ไหน

Home – บ้าน

Pull – ดึง

Good – ดี

Come – มา

Pet – สัตว์เลี้ยง

Big – ใหญ่

Sad – เศร้า

Class – ชั้นเรียน

Plan – วางแผน

Mad – โกรธ

Clap – ปรบมือ

Fun – สนุก

Play – เล่น

Friend – เพื่อน

Toss – ขว้าง

Ball – ลูกบอล

Hop – กระโดดขาเดียว

Quick – รวดเร็ว

Doll – ตุ๊กตา

Rock – หิน / โยก

Game – เกม

Move – เคลื่อนที่

Body – ร่างกาย

Strong – แข็งแรง

Fast – เร็ว

Grass – หญ้า

Catch – จับ

Swim – ว่ายน้ำ

Kick – เตะ

New – ใหม่

There – ที่นั่น

Help – ช่วยเหลือ

Again – อีกครั้ง

Jop – (อาจเป็นการพิมพ์ผิดของ “Job” = งาน)

Bell – กระดิ่ง

Grab – คว้า

Fire – ไฟ

Wet – เปียก

Glad – ยินดี

Live – มีชีวิต / อาศัยอยู่

Then – จากนั้น

Could – สามารถ (ในอดีต)

Mud – โคลน

Mess – ความยุ่งเหยิง

Yell – ตะโกน

Fell – ล้ม

Brick – อิฐ

Stick – ไม้ / ติด

Hut – กระท่อม

Under – ใต้

Pond – บ่อน้ำ

Water – น้ำ